"Mr. Chapo, would not it be a father who started to deal with the good?" Wrote Del Castillo. The capo reconnected with her after her arrest in February 2014, when "the gringos fought to tell their story," Penn wrote in the article. 	 fPenn wrote that Guzman was interested in having a movie filmed on his life and wanted Mexican actress Kate del Castillo, who had portrayed a drug trafficker in a television series, involved in the project.
The magazine was heavily criticized for relying too much on the alleged victim's narration without conducting a basic factual check. 	 The magazine was strongly criticized for relying too strongly on the account of the alleged victim and failing to carry out basic fact-checking.
Strongly armed Mexican Navy personnel drove the onlookers away from the site on Saturday, while a contingent of journalists blocked a lane on the avenue a few blocks from the house. 	 Two months after that close call, marines finally caught him in a residential neighborhood of Los Mochis, where they'd been monitoring a suspected safe house.
Nearly 1.1 million people registered as asylum seekers in Germany last year, including more than 400,000 from Syria, the government said Wednesday. 	 The federal government is trying to avoid a repeat of the summer of 2014, when so many children crossed the border into the U.S. from Guatemala, Honduras and El Salvador that they were forced to stay in Border Patrol facilities, which aren't designed to house children.
For Del Castillo, the acceptance of her character in "The Queen of the South" lay partly in the characteristics of that antagonistic heroine. 	 Penn wrote that Guzman was interested in having a movie filmed on his life and wanted Mexican actress Kate del Castillo, who had portrayed a drug trafficker in a television series, involved in the project.
Guzman makes millions of dollars transporting tons of cocaine and manufacturing and transporting methamphetamine and heroin to markets around the world, the largest of which is in the United States. 	 In the interview, Guzman defends his work at the head of the world's biggest drug trafficking organization, one blamed for thousands of killings.
Some twenty-three of them preferred to stay on the island, either because they left political activism or remained as internal opponents. 	 Among those who remain, at least six men are back in Cuban prison on what their allies say are politically related charges.
Netflix Inc. began the year with 70 million subscribers, and its executives had promised that they would spend about $ 5 billion a year to obtain study distribution rights around the world. 	 The deal will give Netflix Inc. more video likely to appeal to children, an audience segment that has played an important role in its service more than doubling in size to 69 million subscribers during the past three years.
South Korea acted in retaliation for North Korea's nuclear test with broadcasts against Pyongyang across the border on Friday, believed to be the birthday of North Korean leader Kim Jong Un. 	 As world leaders debated ways to penalize North Korea's claim of a fourth nuclear test, South Korea voiced its displeasure with broadcasts of anti-Pyongyang propaganda across the rivals' tense border Friday, believed to be the birthday of North Korean leader Kim Jong Un.
Perez-Reverte himself wrote a message from his Twitter account on Sunday about the meeting between Del Castillo, El Chapo and Penn: "The Queen of the South measured the interview with El Chapo. Tweeted the writer. 	 Penn wrote that Guzman was interested in having a movie filmed on his life and wanted Mexican actress Kate del Castillo, who had portrayed a drug trafficker in a television series, involved in the project.
The company has purchased more and more material that can be seen only through its service, with more than 600 hours of original programming prepared for this year; That number includes more than 50 exclusive programs and films, such as the celebrated series "House of Cards" and "Orange Is the New Black." 	 The expanded licensing agreement announced Tuesday will allow Netflix to showcase several new DreamWorks series, including "Trollhunters," a fantasy created by acclaimed movie director Guillermo del Toro.
So far there has been no reaction from the North Korean authorities, but their response could be severe due to the sensitivity of the date of Kim's birthday, who is believed to be close to 30 years. 	 Pyongyang is extremely sensitive to any outside criticism of the authoritarian leadership of Kim, the third member of his family to rule.
Washington, which for decades made explicit its support for dissent, now said it is also looking for a new policy to open up the island to improve the living conditions of citizens in general, by promoting trade and travel to the island And encouraging the Cuban government to improve telecommunications and a flow of information. 	 American officials say Cuba's opening of at least 58 public Wi-Fi hotspots nationwide shows its new policy is working, even though Cuban officials don't describe the new Internet facilities as a result of detente.
The South Korean army banned the foreign press from approaching the border before the start of the transmissions. 	 South Korea's Defense Ministry couldn't confirm the reports.
Some observers believed that Maduro would initiate some economic reforms after the opposition won a national election for the first time in more than a decade, setting the stage for an unprecedented political confrontation. 	 The court, which has never ruled against the executive branch, had barred the inauguration of the three lawmakers as authorities investigate allegations of voter fraud.
"We are very aware of this among our activists so they do not leave," José Daniel Ferrer, leader of the Cuban Patriotic Union, a group from the east of the island, told the AP. 	 "Our commitment is here," said Jose Daniel Ferrer, leader of the Patriotic Union of Cuba, a group based in the country's east.
Chancellor Angela Merkel has emphasized the importance of diplomacy and getting other European countries to share the burden, but her conservative allies in Bavaria propose to set a limit on the number of refugees the country can accept. 	 Guatemalan officials say a prison riot in the eastern state of Izabal has left eight inmates dead.
Guzman's lawyer, Juan Pablo Badillo, told Milenio newspaper that the defense has already filed six motions against extradition requests. 	 Mexican officials say Sean Penn's contacts with drug lord Joaquin "El Chapo" Guzman helped them track the fugitive down - even if he slipped away from an initial raid on the hideout where the Hollywood actor apparently met him.
At least one of the gunmen fell dead in a house under construction on the other side of the block. 	 Five people died in a gun battle as troops moved in.
While being tried, Bolin and a woman who was part of his defense fell in love. 	 Just after his 2012 re-election, Obama pushed hard for a bipartisan gun control bill that collapsed in the Senate, ending any realistic prospects for a legislative solution in the near term.
The record award sparked an unprecedented sales frenzy. 	 Penn's story ran nine months after Rolling Stone retracted its discredited story about a gang rape at a fraternity party at the University of Virginia.
Broadcasts include popular Korean pop songs, world news, weather forecasts, as well as criticism of North Korea's nuclear tests, its shaken economy and poor human rights conditions, according to the Seoul Ministry of Defense. 	 North Koreans are prohibited from listening to K-pop.
Some twenty-three of them preferred to stay on the island, either because they left political activism or remained as internal opponents. 	 The government historically has characterized them as U.S.-backed mercenaries and for decades has quashed any attempts to organize independent resistance to the single-party state founded by Fidel Castro and run by his brother, Raul.
The magazine turned into news over the weekend by revealing that American actor Sean Penn got an unusual interview late last year with well-known drug lord Joaquin "El Chapo" Guzman when he was on the run after escaping through a tunnel Of a Mexican maximum security prison. 	 The magazine made stunning news over the weekend by revealing that actor Sean Penn landed a rare interview last fall with the notorious drug lord Joaquin "El Chapo" Guzman while Guzman was on the run after escaping through a tunnel from a maximum-security Mexican prison.
Global groups like Amnesty International indicated that it is the Cuban government and not the United States that has to act in its territory. 	 He blamed that notion on the NRA and like-minded groups that convince its members that "somebody's going to come grab your guns."
FIFA's ethics committee has sanctioned Platini and Blatter for eight years last month in determining that they committed unethical conduct in connection with a payment of two million Swiss francs (two million dollars) that Blatter secretly made to Platini in 2011. 	 - A Guatemalan judge indicted in a probe of global soccer corruption must wear an electronic monitor and can't be more than 50 miles from the federal courthouse in Brooklyn, as part of a bail agreement set Thursday by a U.S. magistrate.
"I can not have remorse for this story, because things fell on me without doing anything wrong," he said in an interview at a hotel in Nyon. 	 Later Friday, South Korea was to announce the results of its first round of investigations of samples collected from sea operations to see if radioactive elements leaked from the North's test, according to the Korea Institute of Nuclear Safety.
Venezuelan President Nicolás Maduro has appointed a young socialist as head of the economy as part of a series of cabinet changes. 	 President Nicolas Maduro is doubling down on his existing economic policies with the appointment of a young leftist hardliner to head the country's cratering economy, setting the stage for confrontation between the ruling socialist party and the newly powerful opposition.
Governor Edmund G. Brown Jr. has declared a state of emergency at the request of residents and local officials, who do their utmost to stop the leak of this invisible gas, which many experts consider the greatest natural disaster in the United States. . Since the oil spill of British Petroleum in the Gulf of Mexico. 	 California Governor Jerry Brown declared a state of emergency over a large Southern California gas leak in Los Angeles County, which has led to months of protests and the displacement of thousands of families.
Del Castillo has been married on two occasions: the first with exfutbolista and sports commentator Luis García, who later stated that she was separated on grounds of domestic violence, and the second with actor Aaron Diaz. 	 "He was interested in seeing the story of his life told on film, but would entrust its telling only to Kate," wrote Penn, who appears in a photo posted with the interview shaking hands with Guzman.
Former magazine writers such as Greil Marcus and Jim DeRogatis have accused publisher Jann Wenner of allowing undue data from subjects interviewed or interfering in musical criticism he considered too negative about artists he likes. 	 Describing the capture, Attorney General Arely Gomez said that investigators had been aided in locating Guzman by documented contacts between his attorneys and "actors and producers" she said were interested in making a film about him, though she did not name them.
The capo said he had not used drugs in 20 years and said, about his use of violence, he reported: "I'm looking for problems? 	 When asked if he is to blame for high addiction rates, he responds: "No, that is false, because the day I don't exist, it's not going to decrease in any way at all. Drug trafficking? That's false."
"I can not imagine the pain they suffered," he said of the families of the victims. 	 Obama took questions from Taya Kyle, whose late husband was depicted in the film "American Sniper," and Cleo Pendleton, whose daughter was shot and killed near Obama's Chicago home.
The Powerball fat prize bag has grown steadily from a starting point of $ 40 million on Nov. 4. 	 It is being sued for tens of millions of dollars by the fraternity, former frat members and a university administrator.
The video shows the patrolman with a stun gun in his hand and shouting "I'm going to fire you!" After Bland refuses to leave his car. 	 Dashcam video shows the traffic stop quickly became confrontational, with Encinia holding a stun gun and yelling, "I will light you up!" after Bland refused to get out of her car.
Salas, like Maduro, argues that rampant inflation and the world's most pronounced recession are due to the sabotage of the US economy in complicity with local businessmen. 	 Like Maduro, Salas says the country is suffering from the world's worst recession and triple-digit inflation because business interests are colluding with the U.S. to sabotage the economy.
Governor Edmund G. Brown Jr. has declared a state of emergency at the request of residents and local officials, who do their utmost to stop the leak of this invisible gas, which many experts consider the greatest natural disaster in the United States. . Since the oil spill of British Petroleum in the Gulf of Mexico. 	 The leak at the Southern California Gas Company's Aliso Canyon storage field, which began on October 23, has steadily leaked 62 million cubic feet of methane into the air daily, according to an estimate by the Environmental Defense Fund.
Nearly 1.1 million people registered as asylum seekers in Germany last year, including more than 400,000 from Syria, the government said Wednesday. 	 North Korea claimed on Wednesday that it had successfully detonated a miniature hydrogen bomb, marking the country’s fourth known nuclear test.
The World Health Organization says that the Zika virus, believed to cause fetal malformations, is likely to spread to all countries in the Americas where the mosquito has been found. 	 Such an episode would come in the midst of a presidential election that has already been dominated by concerns over immigration and border security.
Many of those who made their request were asked to prove their status as persecuted or activists, despite being part of the group for which the Department of State negotiated with Cuba. 	 Separate statements from the White House said Obama and the two Asian leaders also agreed to countries "agreed to work together to forge a united and strong international response to North Korea's latest reckless behavior."
The capo said he had not used drugs in 20 years and said, about his use of violence, he reported: "I'm looking for problems? 	 In the interview, Guzman defends his work at the head of the world's biggest drug trafficking organization, one blamed for thousands of killings.
"Dilma will have a month without major problems in Brasilia to present a plan to revive a shaky economy," said Claudio Couto of the Brazilian research institute Fundacao Getulio Vargas. 	 When asked if he is to blame for high addiction rates, he responds: "No, that is false, because the day I don't exist, it's not going to decrease in any way at all. Drug trafficking? That's false."
Mexican authorities say Sean Penn's contacts with drug kingpin Joaquin "El Chapo" Guzman helped them track the fugitive, even though he had escaped from an initial operation in the hideout where he had met with the Hollywood actor. 	 Mexican officials say Sean Penn's contacts with drug lord Joaquin "El Chapo" Guzman helped them track the fugitive down - even if he slipped away from an initial raid on the hideout where the Hollywood actor apparently met him.
Washington, which for decades made explicit its support for dissent, now said it is also looking for a new policy to open up the island to improve the living conditions of citizens in general, by promoting trade and travel to the island And encouraging the Cuban government to improve telecommunications and a flow of information. 	 The White House has sought to portray the NRA, the nation's largest gun group, as possessing a disproportionate influence over lawmakers that has prevented new gun laws despite polls that show broad U.S. support for measures like universal background checks.
The message sent by the new appointment and the combative rhetoric of the Socialists since the swearing in of the new deputies could silence the voices of the dialogues. 	 The new appointment and the socialists' combative stance since the new congress was seated Tuesday could silence opposition voices favoring dialogue.
Penn reported his meticulous security measures, but also noted that when he was flying to Mexico on October 2, "I did not see spy eyes, although I suppose they were there." 	 Penn wrote of elaborate security precautions, but also said that as he flew to Mexico on Oct 2 for the meeting, "I see no spying eyes, but I assume they are there."
Since the electoral victory, the opposition coalition has been divided between those in favor of negotiating with the government and those who want to start the process of removing the president. 	 Since its landmark victory, the opposition coalition has been split between those who favor negotiation with the government and those who want to start to remove Maduro from office.
On the couch in front of him was an M16 rifle, the actor said. 	 Penn wrote of elaborate security precautions, but also said that as he flew to Mexico on Oct 2 for the meeting, "I see no spying eyes, but I assume they are there."
Guzmán was recaptured Friday in the state of Sinaloa, on the Mexican Pacific coast, after a shooting that killed five of his escorts and wounded a soldier from the Navy of Mexico. 	 Guzman was recaptured Friday in Mexico after a shootout that killed five of his associates and wounded one marine.
Most of the detainees are over 65 years old, including retired general Francisco Luis Gordillo and Major General Manuel Antonio Callejas Callejas, who were members of the military leadership in the 1980s. 	 Guatemalan media broadcast images of the former officials in handcuffs, some of them crying and saying their work during the war only involved fighting guerrilla bands.
Professor at the Bolivarian University, created by the late ex-President Hugo Chávez, Salas was relatively unknown, but his economic ideology is known thanks to a large number of open letters and pamphlets. 	 Hundreds of pro-government people rallied in downtown Thursday morning to protest the opposition leadership's removal of portraits of Chavez from the gold-domed capitol building.
A jury investigator formally charged police officer Brian Encinia of the junior charge on the grounds that he lied about how he pulled Sandra Bland, 28, from his vehicle during the traffic stop in July. 	 Encinia is accused of lying about how he removed Bland from her vehicle.
The order also includes measures to protect public health and safety and, in addition, tighten supervision of gas storage facilities. 	 Governor Brown’s proclamation calls for the gas company to stop the leak, protect public safety, ensure accountability and strengthen oversight of gas storage facilities.
It also raised questions about ethics and good judgment, particularly as to whether Penn had to meet secretly with one of the most wanted fugitives, whether the actor crossed the line by allowing Guzman to approve the article before it was published, and whether Penn Trivialized the bloodthirsty past of "El Chapo" by asking questions like "Do you have any dreams?" And "if I could change the world, would I?" 	 Penn's article on Guzman was published late Saturday by Rolling Stone magazine, a day after Mexican marines captured the world's most wanted kingpin in a raid on the city of Los Mochis near the Gulf of California.
Penn said he received credible information that the DEA, the US Drug Enforcement Administration, was tracking the actors as raids intensified after their first meeting. 	 A Mexican federal law enforcement official, speaking on condition of anonymity because he was not permitted to comment on the issue, told the Associated Press the Penn interview led authorities to Guzman in the area of Tamazula, a rural part of Durango state.
Of the 53 prisoners, at least 35 began to process refugee status at the US Embassy, ​​which would allow them to live permanently in the neighboring country. 	 The Shanghai Composite Index on Thursday tumbled 7 percent in 30 minutes before trading was suspended.
Nearly 1.1 million people registered as asylum seekers in Germany last year, including more than 400,000 from Syria, the government said Wednesday. 	 Nearly 1.1 million people were registered as asylum-seekers in Germany last year, more than 400,000 of them from Syria, the government said Wednesday.
At around 4 am Friday, Mexican Navy troops seized the house by storm, which government officials had been monitoring for weeks. 	 Two months after that close call, marines finally caught him in a residential neighborhood of Los Mochis, where they'd been monitoring a suspected safe house.
Exactly one year ago the Cuban government began to release 53 prisoners from a list for which President Barack Obama had interceded in the framework of the reestablishment of relations between Cuba and the United States. 	 A major breakthrough in the Cuba-based talks came in September when negotiators announced a framework for rebels who confess their crimes to avoid jail time and instead serve out sentences helping war-torn rural communities rebuild.
South Korean news agency Yonhap reported that the military fronts deployed near the 11 sites where loudspeakers started launching messages against North Korea at noon (0300 GMT) were under the highest alert level. 	 South Korea's Yonhap news agency reported that frontline troops, near 11 sites where propaganda loudspeakers started blaring messages at noon (0300 GMT), were on highest alert.
Chancellor Angela Merkel has emphasized the importance of diplomacy and getting other European countries to share the burden, but her conservative allies in Bavaria propose to set a limit on the number of refugees the country can accept. 	 "This is where Merkel's irresponsible immigration policy will lead us," declared Thorsten Craemer of the far-right fringe party ProNRW, which staged a small rally in front of Cologne's main train station, the site of the attacks.
The new vice president of economics Luis Salas, 39, has little experience of government, but promotes the price and change control theories that govern Venezuelan economic policy for 17 years. 	 Luis Salas, the new 39-year-old vice president for the economy, has scant administrative experience, but champions the same theories of price and currency controls that have defined Venezuela's leftist economic policy for 17 years.
The actress was contacted by Guzman people after she sent messages through her Twitter account in 2012 in which she mentioned it. 	 "He was interested in seeing the story of his life told on film, but would entrust its telling only to Kate," wrote Penn, who appears in a photo posted with the interview shaking hands with Guzman.
Oscar Ray Bolin, a former carnival employee who was sentenced for killing three women in the Tampa Bay area and who after the trial married a member of his defense was executed in Florida on Thursday. 	 Obama took questions from Taya Kyle, whose late husband was depicted in the film "American Sniper," and Cleo Pendleton, whose daughter was shot and killed near Obama's Chicago home.
Guzman apparently had fled the house through the sewer system and emerged several blocks away, where he boarded a vehicle and continued his escape until the authorities finally caught him. 	 Two months after that close call, marines finally caught him in a residential neighborhood of Los Mochis, where they'd been monitoring a suspected safe house.
Professor at the Bolivarian University, created by the late ex-President Hugo Chávez, Salas was relatively unknown, but his economic ideology is known thanks to a large number of open letters and pamphlets. 	 A professor at the Bolivarian University, an institution created by the late president Hugo Chavez, Salas was relatively unknown before this week.
Exactly one year ago the Cuban government began to release 53 prisoners from a list for which President Barack Obama had interceded in the framework of the reestablishment of relations between Cuba and the United States. 	 Ahead of the town hall, Obama put political candidates on notice that he would refuse to support or campaign for anyone who "does not support common-sense gun reform" - including Democrats.
Prosecutors say Guzman is responsible for hundreds of murders and inciting violence in Mexican cities with the United States as Ciudad Juárez, on the border with El Paso, Texas, in their struggle to control drug trafficking routes. 	 In the interview, Guzman defends his work at the head of the world's biggest drug trafficking organization, one blamed for thousands of killings.
A video recording from the agent's patrol console shows that the road arrest soon turned into a confrontation. 	 Dashcam video shows the traffic stop quickly became confrontational, with Encinia holding a stun gun and yelling, "I will light you up!" after Bland refused to get out of her car.
The online movie and video service debuted in 130 countries on Wednesday in a surprise move that could potentially cost millions of new subscribers. 	 The Internet video service debuted in 130 countries Wednesday in a surprise move likely to reel in millions of new subscribers.
He added that prices do not increase because of scarcity but "because of the relations in the midst of which it occurs, which in the case of capitalist economies are mediated by the desire for individual profit through exploitation of the other: selfishness" . 	 He added that prices go up not because of scarcity, but because of "capitalist economies that are driven by the desire for personal gain through the exploitation of others; by selfishness."
Seven have already left Cuba or are about to do so in the coming weeks, reducing the ranks of the weak and fragmented internal opposition movement. 	 NRA spokesman Andrew Arulanandam said beforehand that the group saw "no reason to participate in a public relations spectacle orchestrated by the White House."
Penn's encounter with Guzman was organized through the Mexican actress Kate del Castillo, known for her role as leader of drug trafficking in the series "The Queen of the South." 	 Penn wrote that Guzman was interested in having a movie filmed on his life and wanted Mexican actress Kate del Castillo, who had portrayed a drug trafficker in a television series, involved in the project.
Writing for Rolling Stone, Penn admitted that Guzman was granted the benefit of approving the article before it was published (Guzman did not request changes, according to the actor), which represents a violation of the general rules of journalistic integrity. 	 Writing for Rolling Stone, Penn acknowledged that Guzman was granted prior approval over the article (Guzman requested no changes, according to the actor), a violation of the commonly held rules of journalistic integrity.
The practice of prior approval discredits the whole story, whether the subject requests change or not, "said Andrew Seaman, chair of the ethics committee of the Society of Professional Journalists, through a blog post titled" Rolling Stone Gathers No Accolades "(Rolling Stone does not receive praise). 	 Penn wrote that Guzman was interested in having a movie filmed on his life and wanted Mexican actress Kate del Castillo, who had portrayed a drug trafficker in a television series, involved in the project.
Michel Platini gave up his desire to become the next president of FIFA. 	 Paraguayan authorities raided the headquarters of the South American soccer confederation Thursday in connection to the sprawling FIFA probe being led by U.S. and Swiss prosecutors.
In mid-December, Obama also indicated that a future assessment of the human rights situation on the island would determine if he would visit Cuba in 2016, in what would constitute the first tour of a US president since triumph Of the revolution five decades ago. 	 In a prime-time, televised town hall meeting, Obama dismissed what he called a "conspiracy" alleging that the federal government - and Obama in particular - wants to seize all firearms as a precursor to imposing martial law.
About two dozen demonstrators attended Wednesday's press conference announcing the indictment against the agent. 	 California Governor Jerry Brown declared a state of emergency over a large Southern California gas leak in Los Angeles County, which has led to months of protests and the displacement of thousands of families.
Netflix Inc. began the year with 70 million subscribers, and its executives had promised that they would spend about $ 5 billion a year to obtain study distribution rights around the world. 	 Increasingly, Netflix has been buying material that only can be seen on its service, with more than 600 hours of original programming lined up for this year.
In another sign of his commitment to the current policy, he created a new ministry of urban agriculture and announced that he and First Lady Cilia Flores would dedicate themselves to that activity. 	 And he created a new urban agriculture ministry and announced that he and first lady Cilia Flores had taken up urban farming themselves.
Netflix has introduced a formula that has proven to be addictive and its service has transformed the entertainment sector by allowing people to see all the material they want at any time on a screen connected to the internet. 	 Netflix has come up with a formula that has proven addictive as its service has transformed the entertainment industry by allowing people to watch video anytime they want on an Internet-connected device.
These court orders are not extradition yet, but the start of a process towards possible extradition. 	 Earlier Saturday, a federal law enforcement official said that Mexico is willing to extradite Guzman to the United States - a move authorities had ruled out before his July escape.
"Mr. Chapo, would not it be a father who started to deal with the good?" Wrote Del Castillo. The capo reconnected with her after her arrest in February 2014, when "the gringos fought to tell their story," Penn wrote in the article. 	 "He was interested in seeing the story of his life told on film, but would entrust its telling only to Kate," wrote Penn, who appears in a photo posted with the interview shaking hands with Guzman.
The order also includes measures to protect public health and safety and, in addition, tighten supervision of gas storage facilities. 	 The proclamation also states that the California Public Utilities Commission will make sure SoCal Gas covers costs related to both the leak and its response, while protecting the company's own ratepayers.
It occupies a corner of a busy avenue of four lanes in a neighborhood where also inhabit politicians of the Mexican city of Los Mochis. 	 Two months after that close call, marines finally caught him in a residential neighborhood of Los Mochis, where they'd been monitoring a suspected safe house.
A few days after the interview, elements of the Mexican Navy launched an operation to capture him, although Attorney General Arely Gomez said Friday that at that time "El Chapo" was accompanied by two women and a girl, so it was decided not to Open fire to avoid injury. 	 Two months after that close call, marines finally caught him in a residential neighborhood of Los Mochis, where they'd been monitoring a suspected safe house.
In total, 1,091,894 migrants were registered between January and December 2015, according to data released by the Ministry of the Interior. 	 Syrians were by far the biggest single group, accounting for 428,468 people.
Castillo had written a public message to Guzman in 2012 from his Twitter account in which he asked the capo to "traffic with good." 	 There was no immediate response from representatives for either Penn or del Castillo to the Mexican official's comments.
Daughter of actor Eric del Castillo, one of the highlights of the so-called Golden Age of Mexican cinema, Kate del Castillo was born on October 23, 1972 in Mexico City. 	 They raided Guzman's remote hideout a few days after the interview and narrowly missed capturing Guzman, whose July escape from Mexico's top security prison - though a mile-long (1.5-kilometer) tunnel - had embarrassed President Enrique Pena Nieto and made his capture a national priority.
Hours earlier Saturday, a Mexican police official said Mexico is ready to extradite Guzman to the United States, a measure that authorities had ruled out before the drug kingpin escaped in July. 	 According to a statement from the Mexican Attorney General's office, the U.S. filed extradition requests June 25, while Guzman was in custody, and another Sep. 3, after he escaped.
Due to the incident, more than 2,000 families were temporarily relocated (due to potential health problems), schools have been closed and airspace has been closed until March, the month in which the leak is expected to be repaired. 	 The gas company had already paid for housing for more than 2,000 other households, according to the Los Angeles Times.
Although Netflix is ​​practically available worldwide, not all its content can be seen everywhere. 	 For instance, a prized licensing contract that gives Netflix the rights to Walt Disney films after their theatrical release will be limited to the U.S. and Canada as part of a deal negotiated several years ago.
According to the prosecution, Ovalle would be linked to forced disappearances, human rights violations, during the war, especially in the military detachment located in Cobán Alta Verapaz, in the north of the country, where he was outstanding. 	 Guatemalan officials say a prison riot in the eastern state of Izabal has left eight inmates dead.
Sean Penn credited the Mexican actress with having arranged a secret meeting between the American actor and the most famous drug lord, which resulted in an exclusive interview published by Rolling Stone magazine. 	 Penn wrote that Guzman was interested in having a movie filmed on his life and wanted Mexican actress Kate del Castillo, who had portrayed a drug trafficker in a television series, involved in the project.
Platini said he will continue with his appeal of punishment, but said the deadline for the Feb. 26 election is too short and precludes his candidacy. 	 South Korea's Yonhap news agency reported that frontline troops, near 11 sites where propaganda loudspeakers started blaring messages at noon (0300 GMT), were on highest alert.
Benedict XVI was the last pope to visit Mexico in March 2012. 	 Penn's article on Guzman was published late Saturday by Rolling Stone magazine, a day after Mexican marines captured the world's most wanted kingpin in a raid on the city of Los Mochis near the Gulf of California.
"Drug trafficking does not depend on one person, it depends on a lot of people," added Guzman. 	 When asked if he is to blame for high addiction rates, he responds: "No, that is false, because the day I don't exist, it's not going to decrease in any way at all. Drug trafficking? That's false."
Three other tickets won two million dollars because they paid extra to multiply smaller prizes. 	 Guzman was recaptured Friday in Mexico after a shootout that killed five of his associates and wounded one marine.
In total, 1,091,894 migrants were registered between January and December 2015, according to data released by the Ministry of the Interior. 	 That euphoria has given way to the realization that integrating the nearly 1.1 million people who came to Germany last year will be a long and difficult task, even as many Germans have been heartened by Merkel's mantra, "We can do this."
According to the magazine, the communication between Del Castillo and El Chapo began in 2014, two years after the extensive letter that the actress published on Twitter, and which earned him some criticism among some of his followers for making an alleged apology to the capo. 	 Penn wrote that Guzman was interested in having a movie filmed on his life and wanted Mexican actress Kate del Castillo, who had portrayed a drug trafficker in a television series, involved in the project.
Penn has also spoken with foreign critics of the United States, such as Fidel Castro and the late Venezuelan President Hugo Chávez. 	 Penn's article on Guzman was published late Saturday by Rolling Stone magazine, a day after Mexican marines captured the world's most wanted kingpin in a raid on the city of Los Mochis near the Gulf of California.
One of the most outstanding roles of Del Castillo has been that of Teresa Mendoza, leader of a drug cartel, in the television series based on the Spanish book Arturo Pérez-Reverte, "The Queen of the South." 	 Penn wrote that Guzman was interested in having a movie filmed on his life and wanted Mexican actress Kate del Castillo, who had portrayed a drug trafficker in a television series, involved in the project.
When asked if his activities affect Mexico, he replied: "not at all." 	 They raided Guzman's remote hideout a few days after the interview and narrowly missed capturing Guzman, whose July escape from Mexico's top security prison - though a mile-long (1.5-kilometer) tunnel - had embarrassed President Enrique Pena Nieto and made his capture a national priority.
When asked if his activities affect Mexico, he replied: "not at all." 	 When asked if he is to blame for high addiction rates, he responds: "No, that is false, because the day I don't exist, it's not going to decrease in any way at all. Drug trafficking? That's false."
Chancellor Angela Merkel has emphasized the importance of diplomacy and getting other European countries to share the burden, but her conservative allies in Bavaria propose to set a limit on the number of refugees the country can accept. 	 Merkel played down the differences as she arrived at an Alpine retreat of Seehofer's Christian Social Union, insisting that her party and his have much more in common than they have divisions.
Kerry told reporters in Washington that he had a telephone conversation with Chinese Foreign Minister Wang Yi on Thursday, adding that Beijing's approach to Pyongyang had failed. 	 The hydrogen bomb already is the global standard for the five nations with the greatest nuclear capabilities: the U.S., Russia, France, Britain and China.
Prosecutors say Guzman is responsible for hundreds of murders and inciting violence in Mexican cities with the United States as Ciudad Juárez, on the border with El Paso, Texas, in their struggle to control drug trafficking routes. 	 According to a statement from the Mexican Attorney General's office, the U.S. filed extradition requests June 25, while Guzman was in custody, and another Sep. 3, after he escaped.
In some cases the response to them was delayed due to the criminal background check that the diplomatic seat should conduct to dissidents, which sometimes have nothing to do with political activities. 	 Angel Yunier Remon, a rapper from the eastern province of Granma, said he also was denied refugee status despite being named by the State Department several times as a victim of political repression before he was freed in January 2015.
Maduro appointed other regime intransigents to hierarchical posts as part of sweeping changes in the cabinet that, he says, are needed to protect the revolution in a new political era. 	 The court, which has never ruled against the executive branch, had barred the inauguration of the three lawmakers as authorities investigate allegations of voter fraud.
Penn got the first interview with Guzman in early October, while the world's most wanted capo was at large after escaping in July from a maximum-security Mexican prison through a complex tunnel. 	 "He was interested in seeing the story of his life told on film, but would entrust its telling only to Kate," wrote Penn, who appears in a photo posted with the interview shaking hands with Guzman.
CEO Reed Hastings revealed the scope of Netflix's expansion at the end of a presentation at the Las Vegas CES, one of the industry's top technology industry events of the year. 	 CEO Reed Hastings revealed the scope of Netflix's expansion at the end of a presentation in Las Vegas at CES, one of the technology industry's marquee events.
The United States Administration is convinced that North Korea has conducted a nuclear test, but the details of the test remain to be determined. 	 The US is confident that North Korea had tested a nuclear bomb, but it wants to get as much data as possible on the details of the event, White House spokesman Josh Earnest said.
Of the 53 prisoners, at least 35 began to process refugee status at the US Embassy, ​​which would allow them to live permanently in the neighboring country. 	 U.S. government information and an Associated Press assessment of the dissidents' lives 12 months after their release shows that at least 35 have asked for refugee status allowing them to move permanently to the U.S., reducing the ranks of an already weak and divided opposition movement.
Guzmán was recaptured Friday in the state of Sinaloa, on the Mexican Pacific coast, after a shooting that killed five of his escorts and wounded a soldier from the Navy of Mexico. 	 Two months after that close call, marines finally caught him in a residential neighborhood of Los Mochis, where they'd been monitoring a suspected safe house.
At his first meeting, Penn asked Guzman for a formal interview to be held a week later, but under pressure from the federal forces, Guzman instead recorded his response to Penn's questions in a video and sent it to Kate del Castillo . 	 Penn wrote that Guzman was interested in having a movie filmed on his life and wanted Mexican actress Kate del Castillo, who had portrayed a drug trafficker in a television series, involved in the project.
Asylum applications have lagged behind arrivals. 	 At least 106 women have come forward to file criminal complaints of sexual assault and robbery during the New Year's Eve festivities, authorities said, including two accounts of rape.
Joaquín "El Chapo" Guzman apparently was looking for an ally of the entertainment industry to help him immortalize him in the movies and appealed to the 43-year-old actress. 	 Penn wrote that Guzman was interested in having a movie filmed on his life and wanted Mexican actress Kate del Castillo, who had portrayed a drug trafficker in a television series, involved in the project.
Guzman's lawyer, Juan Pablo Badillo, told Milenio newspaper that the defense has already filed six motions against extradition requests. 	 U.S. government information and an Associated Press assessment of the dissidents' lives 12 months after their release shows that at least 35 have asked for refugee status allowing them to move permanently to the U.S., reducing the ranks of an already weak and divided opposition movement.
"The writer, who in this case is an actor and activist, could have written the story in a more favorable light and skipped unflattering facts in an attempt not to be rejected." 	 Penn wrote that Guzman was interested in having a movie filmed on his life and wanted Mexican actress Kate del Castillo, who had portrayed a drug trafficker in a television series, involved in the project.
"The pope does not have the pretension to come to solve the problems. Mexico, like every country, has immense riches and beauties, but there are problems is normal like any country," Pierre told a news conference. 	 In the interview, Guzman defends his work at the head of the world's biggest drug trafficking organization, one blamed for thousands of killings.
The fraternity, former members of the fraternity and a university administrator claimed for tens of millions of dollars to publish. 	 Penn's article on Guzman was published late Saturday by Rolling Stone magazine, a day after Mexican marines captured the world's most wanted kingpin in a raid on the city of Los Mochis near the Gulf of California.
The supreme pontiff will be in the capital of Mexico and in three more states of the country in the first days of February. 	 A Mexican federal law enforcement official, speaking on condition of anonymity because he was not permitted to comment on the issue, told the Associated Press the Penn interview led authorities to Guzman in the area of Tamazula, a rural part of Durango state.
"We think that the level of refugees and asylum seekers who have arrived in Germany is too high and we are working to ensure that this does not happen on that scale in 2016," de Maiziere said. 	 Amid widespread shock over a string of sexual assaults in this cosmopolitan German city on New Year's Eve, the response was divided Wednesday: blame the police or chide the victims, deport criminal foreigners or prevent migrants from entering the country in the first place.
Some twenty-three of them preferred to stay on the island, either because they left political activism or remained as internal opponents. 	 Cuban officials did not respond to requests for comment on how the freed dissidents are faring.
Penn's article was published nine months after Rolling Stone retracted his discredited story about gang rape during a fraternity party at the University of Virginia. 	 Penn's story ran nine months after Rolling Stone retracted its discredited story about a gang rape at a fraternity party at the University of Virginia.
The Rolling Stone spokeswoman did not immediately return requests for comment. 	 Un vocero de la revista Rolling Stone no respondió de inmediato solicitudes de cometario de The Associated Press.
Guzman makes millions of dollars transporting tons of cocaine and manufacturing and transporting methamphetamine and heroin to markets around the world, the largest of which is in the United States. 	 When asked if he is to blame for high addiction rates, he responds: "No, that is false, because the day I don't exist, it's not going to decrease in any way at all. Drug trafficking? That's false."
In private, US officials expressed concern over Cuba's lack of interest in a policy change and criticized for example the island's government's decision to prevent thousands of medical specialists from leaving the country without special authorization. 	 The plan has drawn intense criticism from gun rights groups that have accused the president of trampling on the Second Amendment and railroading Congress by taking action on his own without new laws.
"It is the legitimate right of a sovereign state and a just action that no one can criticize," Kim said during his tour of the People's Armed Forces Ministry, according to press reports. 	 "Allowing any source control over a story's content is inexcusable. The practice of pre-approval discredits the entire story - whether the subject requests changes or not," Andrew Seaman, chairman of the ethics committee of the Society of Professional Journalists, said in a blog post titled "Rolling Stone Gathers No Accolades."
"We want them to abandon any nuclear activity and comply with international commitments and obligations, and until they do, they will not achieve the prosperity and security they want, they will live in isolation," he said. 	 Ministry officials refused to elaborate about what U.S. military assets were under consideration, but they likely refer to B-52 bombers, F-22 stealth fighters and nuclear-powered submarines.
In the interview published on Saturday night, Guzman said he entered the drug business at age 15 because there was no other way to survive. 	 In the interview, Guzman defends his work at the head of the world's biggest drug trafficking organization, one blamed for thousands of killings.
The interview, conducted in the remote town of Tamazula, in the sierra of the neighboring state of Durango, allowed Mexican authorities to track the drug trafficker, a federal official told The Associated Press on Saturday. 	 Describing the capture, Attorney General Arely Gomez said that investigators had been aided in locating Guzman by documented contacts between his attorneys and "actors and producers" she said were interested in making a film about him, though she did not name them.
"The interviews (with the detainees) showed that these families had actual asylum cases but were not given a genuine opportunity to present them at their immigration court hearings," said Katie Shepherd, a coalition attorney. 	 The suspects face charges of crimes against humanity involving massacres and disappearances of people by security forces under their command.
In the text, Penn describes a complex travel itinerary with private jets and a seven-hour journey through a mountainous jungle in a two-truck convoy. 	 Penn wrote of elaborate security precautions, but also said that as he flew to Mexico on Oct 2 for the meeting, "I see no spying eyes, but I assume they are there."
Shortage of commodities and inflation are the main concern of Venezuelans, many of whom spend hours each week queuing for goods increasingly far from their economic possibilities. 	 Along with shortages, inflation has become the No. 1 concern among Venezuelan voters, many of whom spend hours each week waiting in line for goods that are increasingly impossible to afford.
Also a producer and activist for the PETA Latino animal advocacy organization, Del Castillo recently participated in a chapter on "Hot & Bothered", a television series starring Eva Longoria. 	 "He was interested in seeing the story of his life told on film, but would entrust its telling only to Kate," wrote Penn, who appears in a photo posted with the interview shaking hands with Guzman.
The Powerball is played in 44 states and the District of Columbia, the US Virgin Islands and Puerto Rico. 	 In 2002, as the U.S. was threatening war against Saddam Hussein's Iraq, Penn visited the country and met with senior officials. He has also spoken with such foreign critics of the U.S. as Fidel Castro and Venezuelan leader Hugo Chavez.
North Korea said in a media statement that it carried out a successful test of a hydrogen bomb at a polygon in the north of the country. 	 North Korea claimed on Wednesday that it had successfully detonated a miniature hydrogen bomb, marking the country’s fourth known nuclear test.
Matthews, 26, was abducted from a post office in Pasco County, north of Tampa. 	 Obama took questions from Taya Kyle, whose late husband was depicted in the film "American Sniper," and Cleo Pendleton, whose daughter was shot and killed near Obama's Chicago home.
Writing for Rolling Stone, Penn admitted that Guzman was granted the benefit of approving the article before it was published (Guzman did not request changes, according to the actor), which represents a violation of the general rules of journalistic integrity. 	 Penn wrote that Guzman was interested in having a movie filmed on his life and wanted Mexican actress Kate del Castillo, who had portrayed a drug trafficker in a television series, involved in the project.
Fear gained ground after immigration authorities arrested 121 unauthorized immigrants, mostly parents and children, during a Saturday and Sunday operation in Georgia, Texas and North Carolina. 	 Children in the shelters, most of them between ages 14 and 17, stay an average of 32 days.
"China now had a particular focus that I wanted to do, and we agreed and gave them space to put it into practice, but today, in my conversation with China, I made it very clear that it has not worked and that we can not continue as we have done" "Kerry said. 	 The hydrogen bomb already is the global standard for the five nations with the greatest nuclear capabilities: the U.S., Russia, France, Britain and China.
For Washington, the release was a sign of how the change of its strategy towards the Caribbean nation paid off. 	 Obama says he could make the first visit by a sitting U.S. president to post-revolutionary Cuba as early as this spring if he thinks human rights on the island are improving and a presidential trip will help.
Some twenty-three of them preferred to stay on the island, either because they left political activism or remained as internal opponents. 	 When South Korea briefly resumed propaganda broadcasts in August after an 11-year break, Seoul says the two Koreas exchanged artillery fire, followed by threats of war.
Among the dissenting views on the binational thaw is divided: some argue that the United States focuses on diplomatic and economic relations rather than bet on an improvement in human rights. 	 A number of Cuban activists say the new U.S. policy of engagement focuses on diplomatic and economic ties instead of improving human rights.
There are announcements of layoffs every day, from sugar factories to steel companies. Even gigantic retailer Wal-Mart, one of Brazil's largest supermarket chains, said it would close 30 stores in January. 	 "The writer, who in this case is an actor and activist, may write the story in a more favorable light and omit unflattering facts in an attempt to not to be rejected."
Yonhap reported that Seoul has deployed missiles, artillery and other weapons systems near the border to respond in the fastest manner to any North Korean provocation. 	 Yonhap said Seoul had deployed missiles, artillery and other weapons systems near the border to swiftly deal with any possible North Korean provocation.
President Juan Manuel Santos defended on Thursday the transitional justice agreement that his government agreed with the FARC at a meeting in which he analyzed with his work team what appears to be the final stretch of the peace process with that guerrilla group. 	 President Barack Obama will host his counterpart from Colombia in February to stand with his staunchest ally in South America as peace talks with leftist rebels enter a critical phase that may require additional U.S. support.
The Guatemalan prosecutor's office has requested that the immunity of President-elect Jimmy Morales' top adviser be removed for being related to human rights violations during the 1960-96 war. 	 Prosecutors also moved to have the immunity of office lifted for Edgar Justino Ovalle, a member and co-founder of the party of Morales, who is scheduled to be inaugurated as president next week.
As a child she was immersed in the world of cinema, theater and television, but her first success came in 1991 with the telenovela "Muchachitas", where she gave birth to one of four friends eager to become famous and find love. 	 "He was interested in seeing the story of his life told on film, but would entrust its telling only to Kate," wrote Penn, who appears in a photo posted with the interview shaking hands with Guzman.
The former Juventus midfielder and the French national team did not openly endorse UEFA general secretary Gianni Infantino, one of the candidates and backed by the European body. 	 A statement from the Public Ministry said investigators were combing the headquarters in search of documents or information on computer hard drives related to the FIFA case.
The Guatemalan Forensic Anthropology Foundation has managed to recover the remains of 534 people who were buried there after being killed by soldiers, including indigenous children of the Achí, Pocomchí, Queqchí, Kiché and Ladinos ethnic groups. 	 Government security forces have been blamed for the vast majority of the 245,000 killings and disappearances during the conflict.
In an interview for Rolling Stone with American actor Sean Penn, newly recaptured Mexican drug lord Joaquin "El Chapo" Guzman showed no remorse for leading one of the world's largest drug cartels. 	 Penn wrote that Guzman was interested in having a movie filmed on his life and wanted Mexican actress Kate del Castillo, who had portrayed a drug trafficker in a television series, involved in the project.
Matthews's mother, Kathleen Reeves, and the Collins family were present at the execution. 	 Obama took questions from Taya Kyle, whose late husband was depicted in the film "American Sniper," and Cleo Pendleton, whose daughter was shot and killed near Obama's Chicago home.
Some observers believed that Maduro would initiate some economic reforms after the opposition won a national election for the first time in more than a decade, setting the stage for an unprecedented political confrontation. 	 Disbelief at the president's choice for a new economic czar echoed in opposition circles Wednesday night, with some speculating Maduro might be trying to drive the economy into the ground.
Penn wrote that Guzman was interested in filming a movie about his life and wanted to participate in the project Mexican actress Kate del Castillo, who has played a drug dealer in a television series. 	 "He was interested in seeing the story of his life told on film, but would entrust its telling only to Kate," wrote Penn, who appears in a photo posted with the interview shaking hands with Guzman.
During his visit, Pope Francis will visit the states of Chiapas (south), Michoacan (west) and Chihuahua (north), where he is scheduled to visit a prison, among other activities. 	 A Mexican federal law enforcement official, speaking on condition of anonymity because he was not permitted to comment on the issue, told the Associated Press the Penn interview led authorities to Guzman in the area of Tamazula, a rural part of Durango state.
The 60-year-old Frenchman was not allowed to circumvent the FIFA appeals process, so he can only go to the TAS once his case is heard by the body's appeals committee. 	 There was no immediate reaction by the North, but its response could be especially harsh because of the high emotions surrounding the likely birthday of Kim, who is believed to be in his early 30s. North Korean military forces often compete to show their loyalty to the leader.
August broadcasts, which began after Seoul blamed Pyongyang for a landmine that mutilated two South Korean soldiers, halted only after rival nations agreed on a series of measures to ease tensions. 	 South Korean and U.S. military leaders also discussed the deployment of U.S. "strategic assets" in the wake of the North's test, Seoul's Defense Ministry said.
Penn wrote that Guzman was interested in filming a movie about his life and wanted to participate in the project Mexican actress Kate del Castillo, who has played a drug dealer in a television series. 	 After the opposition swept Dec. 6 legislative elections, Salas wrote an open letter in which he attacked as "pragmatists" those people within the socialist camp who were floating the possibility of a currency devaluation, a move that outside economists agree is a necessary first step for righting the economy.
"I know that one day I will die," he said in the interview. 	 Five people died in a gun battle as troops moved in.
About three thousand applications for special driver licenses for unauthorized immigrants in California were pending at the end of 2015, a spokesman for the state agency charged with issuing these documents said on Wednesday. 	 California Governor Jerry Brown declared a state of emergency over a large Southern California gas leak in Los Angeles County, which has led to months of protests and the displacement of thousands of families.
Germany received more refugees and migrants from other causes than any other European country. 	 Germany was one of the few European countries to welcome the influx of refugees last year.
Seven have already left Cuba or are about to do so in the coming weeks, reducing the ranks of the weak and fragmented internal opposition movement. 	 Seven have either left Cuba for or are preparing to leave this month.
US Navy Vice Admiral Joseph Aucoin, commander of the 7th fleet based in Yokosuka, Japan, says the Navy is closely watching North Korea after its fourth nuclear test. 	 The broadcasts include popular Korean pop songs, world news and weather forecasts as well as criticism of the North's nuclear test, its troubled economy and dire human rights conditions, according to Seoul's Defense Ministry. Included are songs by a young female singer, IU, whose sweet, girlish voice might be aimed at North Korean soldiers deployed near the border.
The magazine turned into news over the weekend by revealing that American actor Sean Penn got an unusual interview late last year with well-known drug lord Joaquin "El Chapo" Guzman when he was on the run after escaping through a tunnel Of a Mexican maximum security prison. 	 They raided Guzman's remote hideout a few days after the interview and narrowly missed capturing Guzman, whose July escape from Mexico's top security prison - though a mile-long (1.5-kilometer) tunnel - had embarrassed President Enrique Pena Nieto and made his capture a national priority.
Penn wrote that Guzman was interested in filming a movie about his life and wanted to participate in the project Mexican actress Kate del Castillo, who has played a drug dealer in a television series. 	 Describing the capture, Attorney General Arely Gomez said that investigators had been aided in locating Guzman by documented contacts between his attorneys and "actors and producers" she said were interested in making a film about him, though she did not name them.
"We want them to abandon any nuclear activity and comply with international commitments and obligations, and until they do, they will not achieve the prosperity and security they want, they will live in isolation," he said. 	 It may take weeks or longer to confirm or refute the North's claim that it successfully tested a hydrogen bomb, which would mark a major and unanticipated advance for its still-limited nuclear arsenal.
Professor at the Bolivarian University, created by the late ex-President Hugo Chávez, Salas was relatively unknown, but his economic ideology is known thanks to a large number of open letters and pamphlets. 	 At the rally Thursday outside the National Assembly in Plaza Bolivar, hundreds of government supporters dressed in red swore loyalty to Chavez and Bolivar.
Chancellor Angela Merkel has emphasized the importance of diplomacy and getting other European countries to share the burden, but her conservative allies in Bavaria propose to set a limit on the number of refugees the country can accept. 	 Police descriptions of the perpetrators as of "Arab or North African origin" were seized on by those calling for an end to Chancellor Angela Merkel's open-door policy toward people fleeing violence and persecution - even as authorities warned they don't know if any of the culprits are refugees.
Rosalie Bolin maintained that her husband was innocent of Matthews' death, and has been one of the most outspoken opponents of the death penalty in the state since he married Bolin. 	 Obama's actions on guns have drawn major attention in the presidential campaign, with the Democratic candidates backing Obama and the Republicans unanimously voicing opposition.
Her credits also include the films "Bordertown" (2006), about the murder of women on the border between Ciudad Juárez and El Paso, Texas, and "Trade" (2007), a tragedy about human trafficking. 	 Describing the capture, Attorney General Arely Gomez said that investigators had been aided in locating Guzman by documented contacts between his attorneys and "actors and producers" she said were interested in making a film about him, though she did not name them.
In opposing circles, disbelief was mounting Wednesday night when the new head of the economy was appointed, with some speculating that Maduro wants to destroy the economy. 	 Socialist supporters have supported appointment of the new economic czar.
Cuban officials did not respond to requests for comment on the issue. 	 Later Friday, South Korea was to announce the results of its first round of investigations of samples collected from sea operations to see if radioactive elements leaked from the North's test, according to the Korea Institute of Nuclear Safety.
López Valdez said Saturday that he was surprised that Guzman's recapture occurred in Los Mochis, a city of about 250,000 people near the Gulf of California coast. 	 They raided Guzman's remote hideout a few days after the interview and narrowly missed capturing Guzman, whose July escape from Mexico's top security prison - though a mile-long (1.5-kilometer) tunnel - had embarrassed President Enrique Pena Nieto and made his capture a national priority.
In some cases the response to them was delayed due to the criminal background check that the diplomatic seat should conduct to dissidents, which sometimes have nothing to do with political activities. 	 The broadcasts will draw a furious response from North Korea, which considers them an act of psychological warfare.
From Atlanta to Los Angeles, fears grew among Hispanics who were not allowed to live in the United States as a result of weekend raids, according to Latino activists and immigrants who believe they could be detained. 	 The federal government is trying to avoid a repeat of the summer of 2014, when so many children crossed the border into the U.S. from Guatemala, Honduras and El Salvador that they were forced to stay in Border Patrol facilities, which aren't designed to house children.
It also raised questions about ethics and good judgment, particularly as to whether Penn had to meet secretly with one of the most wanted fugitives, whether the actor crossed the line by allowing Guzman to approve the article before it was published, and whether Penn Trivialized the bloodthirsty past of "El Chapo" by asking questions like "Do you have any dreams?" And "if I could change the world, would I?" 	 It also raised questions of ethics and judgment, namely whether Penn should have met secretly with one of the world's most-wanted fugitives, whether the actor crossed the line by giving Guzman approval over the article before it was published, and whether Penn trivialized El Chapo's murderous past by asking him such questions as "Do you have any dreams?" and "If you could change the world, would you?"
Former magazine writers such as Greil Marcus and Jim DeRogatis have accused publisher Jann Wenner of allowing undue data from subjects interviewed or interfering in musical criticism he considered too negative about artists he likes. 	 Penn wrote that Guzman was interested in having a movie filmed on his life and wanted Mexican actress Kate del Castillo, who had portrayed a drug trafficker in a television series, involved in the project.
Kate del Castillo, the star of the telenovela "La Reina del Sur" (The Queen of the South), who has portrayed powerful women in the world of drug trafficking in film and television, has been linked to the real world of drug lords. 	 "He was interested in seeing the story of his life told on film, but would entrust its telling only to Kate," wrote Penn, who appears in a photo posted with the interview shaking hands with Guzman.
Five armed men were killed and six more were arrested. 	 Five people died in a gun battle as troops moved in.
Apparently authorities lost track of him, but were later placed in a house in the town of Los Mochis that was guarded a month before the seamen took her by storm Friday. 	 Two months after that close call, marines finally caught him in a residential neighborhood of Los Mochis, where they'd been monitoring a suspected safe house.
Some twenty-three of them preferred to stay on the island, either because they left political activism or remained as internal opponents. 	 "There's a very serious concern in this country about personal security," he added.
Netflix Inc. began the year with 70 million subscribers, and its executives had promised that they would spend about $ 5 billion a year to obtain study distribution rights around the world. 	 Netflix's success has emboldened rivals such as Amazon.com and Hulu to spend more on their own video, triggering bidding battles for digital programming rights.
At his first meeting, Penn asked Guzman for a formal interview to be held a week later, but under pressure from the federal forces, Guzman instead recorded his response to Penn's questions in a video and sent it to Kate del Castillo . 	 "He was interested in seeing the story of his life told on film, but would entrust its telling only to Kate," wrote Penn, who appears in a photo posted with the interview shaking hands with Guzman.
Nearly 1.1 million people registered as asylum seekers in Germany last year, including more than 400,000 from Syria, the government said Wednesday. 	 According to the U.S. Border Patrol, 10,588 unaccompanied children crossed the U.S.-Mexico border in October and November, more than double the 5,129 who crossed during the same two months last year.
The mother of the governor of the state of Sinaloa, Mario López Valdez, has a house two blocks away, with a 24-hour police presence. 	 Two months after that close call, marines finally caught him in a residential neighborhood of Los Mochis, where they'd been monitoring a suspected safe house.
The capo said he had not used drugs in 20 years and said, about his use of violence, he reported: "I'm looking for problems? 	 They raided Guzman's remote hideout a few days after the interview and narrowly missed capturing Guzman, whose July escape from Mexico's top security prison - though a mile-long (1.5-kilometer) tunnel - had embarrassed President Enrique Pena Nieto and made his capture a national priority.
When the opposition won by a large majority in the legislative elections on December 6, Salas in an open letter attacked the "pragmatists" of the socialist camp who mentioned the possibility of a devaluation, a move that outside economists consider a necessary first step for To clean up the economy. 	 Since its landmark victory, the opposition coalition has been split between those who favor negotiation with the government and those who want to start to remove Maduro from office.
The message sent by the new appointment and the combative rhetoric of the Socialists since the swearing in of the new deputies could silence the voices of the dialogues. 	 Hundreds of pro-government people rallied in downtown Thursday morning to protest the opposition leadership's removal of portraits of Chavez from the gold-domed capitol building.
"Drug trafficking does not depend on one person, it depends on a lot of people," added Guzman. 	 Mexican officials say Sean Penn's contacts with drug lord Joaquin "El Chapo" Guzman helped them track the fugitive down - even if he slipped away from an initial raid on the hideout where the Hollywood actor apparently met him.
The magazine turned into news over the weekend by revealing that American actor Sean Penn got an unusual interview late last year with well-known drug lord Joaquin "El Chapo" Guzman when he was on the run after escaping through a tunnel Of a Mexican maximum security prison. 	 Mexican officials say Sean Penn's contacts with drug lord Joaquin "El Chapo" Guzman helped them track the fugitive down - even if he slipped away from an initial raid on the hideout where the Hollywood actor apparently met him.
A powerful US B-52 bomber flew low over South Korea on Sunday in a clear display of Washington's strength as a deep Cold War-style crisis deepens between its ally Seoul and North Korea , After the fourth nuclear test of Pyongyang. 	 In 2002, as the U.S. was threatening war against Saddam Hussein's Iraq, Penn visited the country and met with senior officials. He has also spoken with such foreign critics of the U.S. as Fidel Castro and Venezuelan leader Hugo Chavez.
Penn's article was published nine months after Rolling Stone retracted his discredited story about gang rape during a fraternity party at the University of Virginia. 	 Penn's article on Guzman was published late Saturday by Rolling Stone magazine, a day after Mexican marines captured the world's most wanted kingpin in a raid on the city of Los Mochis near the Gulf of California.
The prosecution confirmed that at least 13 other soldiers were detained for the same case, including Gen. Benedicto Lucas Garcia, brother and former chief of the staff of the late ex-president Romeo Lucas Garcia (1978-1982). 	 Among the 14 people detained was Benedicto Lucas Garcia, a former army commander credited with founding paramilitary groups during the 1960-1996 conflict.
Penn's lengthy and occasionally bewildering essay, which received widespread scorn in social media media, included comments from Guzman of all kinds, from his childhood to his reflections on the drug trade. 	 In the interview, Guzman defends his work at the head of the world's biggest drug trafficking organization, one blamed for thousands of killings.
"North Korea's nuclear test is a flagrant violation of its international obligations," he said. 	 "Allowing any source control over a story's content is inexcusable. The practice of pre-approval discredits the entire story - whether the subject requests changes or not," Andrew Seaman, chairman of the ethics committee of the Society of Professional Journalists, said in a blog post titled "Rolling Stone Gathers No Accolades."
However, some close combinations allowed some people to become rich anyway: 25 of the tickets won a million dollars, as five of the numbers coincided. 	 Penn, an Oscar-winning actor who played a drug dealer in the 1985 movie "The Falcon and the Snowman," has had news-making encounters in other countries.
In some cases the response to them was delayed due to the criminal background check that the diplomatic seat should conduct to dissidents, which sometimes have nothing to do with political activities. 	 Many applications have been delayed by vetting of the dissidents' criminal records, some of which have little to do with political activity.
Washington, which for decades made explicit its support for dissent, now said it is also looking for a new policy to open up the island to improve the living conditions of citizens in general, by promoting trade and travel to the island And encouraging the Cuban government to improve telecommunications and a flow of information. 	 The broadcasts include popular Korean pop songs, world news and weather forecasts as well as criticism of the North's nuclear test, its troubled economy and dire human rights conditions, according to Seoul's Defense Ministry. Included are songs by a young female singer, IU, whose sweet, girlish voice might be aimed at North Korean soldiers deployed near the border.
Of the 53 prisoners, at least 35 began to process refugee status at the US Embassy, ​​which would allow them to live permanently in the neighboring country. 	 There was no immediate reaction by the North, but its response could be especially harsh because of the high emotions surrounding the likely birthday of Kim, who is believed to be in his early 30s.
Pope Francisco does not intend to solve the problems that afflict Mexico during his next visit, said Sunday the apostolic nuncio Christophe Pierre. 	 The Mexican government determined they were valid within the extradition treaty and sent them to a panel of federal judges, who gave orders for detention on July 29 and Sept. 8, after Guzman had escaped.
The magazine turned into news over the weekend by revealing that American actor Sean Penn got an unusual interview late last year with well-known drug lord Joaquin "El Chapo" Guzman when he was on the run after escaping through a tunnel Of a Mexican maximum security prison. 	 Penn's article on Guzman was published late Saturday by Rolling Stone magazine, a day after Mexican marines captured the world's most wanted kingpin in a raid on the city of Los Mochis near the Gulf of California.
Germany received more refugees and migrants from other causes than any other European country. 	 The reaction in Cologne reflects a broader debate as Germany struggles to reconcile law and order with its new-found role as a haven for those seeking a better life.
Thelma Aldana, Attorney General and head of the Public Prosecutor's Office, told a press conference that "the cases we have documented against non-combatant civilians, including children," were one of the largest forced disappearances in Latin America. . 	 In an interview on "Bill Bennett's Morning in America" before Christmas, House Speaker Paul Ryan said officials want to be prepared for another influx and place children in the "least restrictive environment possible."
In the video, Guzman says that he grew up poor and that he sold oranges, soft drinks and candy as a child. 	 In the interview, Guzman defends his work at the head of the world's biggest drug trafficking organization, one blamed for thousands of killings.
Among the dissenting views on the binational thaw is divided: some argue that the United States focuses on diplomatic and economic relations rather than bet on an improvement in human rights. 	 The broadcasts include popular Korean pop songs, world news and weather forecasts as well as criticism of the North's nuclear test, its troubled economy and dire human rights conditions, according to Seoul's Defense Ministry. Included are songs by a young female singer, IU, whose sweet, girlish voice might be aimed at North Korean soldiers deployed near the border.
Lawmaker Lee Cheol Woo stated that the country's National Intelligence Service had indicated that the North Korean bomb was atomic, not hydrogen. 	 North Korea claimed on Wednesday that it had successfully detonated a miniature hydrogen bomb, marking the country’s fourth known nuclear test.
Another half-a-dozen of the 53 are again in jail on charges their allies say are political, one of them for jumping the fence of the US Embassy to try to penetrate the diplomatic headquarters. 	 Among those who remain, at least six men are back in Cuban prison on what their allies say are politically related charges.
Pyongyang is extremely sensitive to any external criticism of Kim's authoritarian leadership, the third member of his family to rule. 	 The North's state media has yet to mention Kim's birthday or South Korea's loudspeaker campaign.
"Mexico is ready, there are plans for cooperation with the United States," said the official, who spoke on condition of anonymity because he was not authorized to comment on the case. 	 But he cautioned it could take at least six months to approve extradition through courts, where Guzman's attorneys can battle a move to the U.S., where he faces drug trafficking charges in several states.
When the opposition won by a large majority in the legislative elections on December 6, Salas in an open letter attacked the "pragmatists" of the socialist camp who mentioned the possibility of a devaluation, a move that outside economists consider a necessary first step for To clean up the economy. 	 After the opposition swept Dec. 6 legislative elections, Salas wrote an open letter in which he attacked as "pragmatists" those people within the socialist camp who were floating the possibility of a currency devaluation, a move that outside economists agree is a necessary first step for righting the economy.
August broadcasts, which began after Seoul blamed Pyongyang for a landmine that mutilated two South Korean soldiers, halted only after rival nations agreed on a series of measures to ease tensions. 	 August's broadcasts, which began after Seoul blamed Pyongyang for land mine explosions that maimed two South Korean soldiers, stopped only after the rivals agreed on a set of measures aimed at easing anger.
Attorney General Rodrigo Janot has requested that Cunha be arrested and removed from office, which will be decided by the Supreme Court. 	 Rolling Stone has long mixed aggressive investigative and political reporting with coverage of rock stars and other celebrities.
Neighbors said there was an intense shooting for about two hours. 	 Five people died in a gun battle as troops moved in.
"The Pope, as head of the Catholic Church, comes to meet the Mexican people, but it is a pastoral visit. He does not come, because I have read a lot of the press, which comes to solve problems of violence and disappearances," added Pierre . 	 In the interview, Guzman defends his work at the head of the world's biggest drug trafficking organization, one blamed for thousands of killings.
Now Netflix is ​​available in 21 languages ​​and is transmitted virtually in every market in which it has targeted, with the notable exception of China, the most populous country in the world. 	 The video streaming company said it was launching its service globally and added service in several new languages including Arabic and Korean.
The B-52, accompanied by F-15 South Korean and US F-16 fighters, returned to its base in Guam at the end of the flight, the US military command said. 	 In 2002, as the U.S. was threatening war against Saddam Hussein's Iraq, Penn visited the country and met with senior officials.
Guzmán was recaptured Friday in the town of Los Mochis, in his home state of Sinaloa, after a shootout in which five of his associates died and a Mexican Navy cash was wounded. 	 Two months after that close call, marines finally caught him in a residential neighborhood of Los Mochis, where they'd been monitoring a suspected safe house.
"They are witnessing the birth of a worldwide television network," Hastings said on stage. 	 "You are witnessing the birth of a global TV network," Hastings crowed on stage.
Of the 53 prisoners, at least 35 began to process refugee status at the US Embassy, ​​which would allow them to live permanently in the neighboring country. 	 South Korea's Yonhap news agency reported that frontline troops, near 11 sites where propaganda loudspeakers started blaring messages at noon (0300 GMT), were on highest alert.
So far there has been no reaction from the North Korean authorities, but their response could be severe due to the sensitivity of the date of Kim's birthday, who is believed to be close to 30 years. 	 North Korea didn't immediately react, but its response could be especially harsh because of the high emotions surrounding the likely birthday of Kim, who is believed to be in his early 30s.
The two-story building is removed from the street and completely covered by the tops of leafy trees. 	 Two months after that close call, marines finally caught him in a residential neighborhood of Los Mochis, where they'd been monitoring a suspected safe house.
The practice of prior approval discredits the whole story, whether the subject requests change or not, "said Andrew Seaman, chair of the ethics committee of the Society of Professional Journalists, through a blog post titled" Rolling Stone Gathers No Accolades "(Rolling Stone does not receive praise). 	 Penn's article on Guzman was published late Saturday by Rolling Stone magazine, a day after Mexican marines captured the world's most wanted kingpin in a raid on the city of Los Mochis near the Gulf of California.
Nelson Barbosa, who was named finance minister after Joaquim Levy stepped down in December, works both on a stimulus package and on tax reforms, all of which are expected to be proposed in the coming weeks. 	 Rolling Stone has long mixed aggressive investigative and political reporting with coverage of rock stars and other celebrities.
A Texas police officer was charged with perjury on Wednesday in connection with a controversial traffic stop in the middle of last year in which a black woman was arrested and three days later she died in jail. 	 A Texas state trooper has been charged with perjury for conduct related to a contentious traffic stop of a black woman who was eventually arrested for assault and then died three days later in jail.
A jury investigator formally charged police officer Brian Encinia of the junior charge on the grounds that he lied about how he pulled Sandra Bland, 28, from his vehicle during the traffic stop in July. 	 A grand jury indicted Trooper Brian Encinia on Wednesday with the misdemeanor charge.
According to the prosecution, Ovalle would be linked to forced disappearances, human rights violations, during the war, especially in the military detachment located in Cobán Alta Verapaz, in the north of the country, where he was outstanding. 	 National disaster response spokesman David de Leon said Monday that particulate matter had fallen on at least eight nearby towns.
He also tweeted that he believed "more in Chapo Guzman than in governments." 	 In the interview, Guzman defends his work at the head of the world's biggest drug trafficking organization, one blamed for thousands of killings.
"Where I grew up there was no other way, nor is there, to survive and there was no other way to carry out our economy in order to live," the capo is heard to say in an audio that accompanies the interview, in which he speaks Of how he began to grow and sell poppies and marijuana as a teenager. 	 When asked if he is to blame for high addiction rates, he responds: "No, that is false, because the day I don't exist, it's not going to decrease in any way at all. Drug trafficking? That's false."
Kim issued his first public statements on the test last week during a visit to the country's military headquarters, where he described the explosion as a "self-defense measure" to protect the region "from the danger of nuclear war provoked by the imperialists Led by the United States, "according to an office released Sunday by the state-run Korean Central News Agency. 	 Writing for Rolling Stone, Penn acknowledged that Guzman was granted prior approval over the article (Guzman requested no changes, according to the actor), a violation of the commonly held rules of journalistic integrity.
The online movie and video service debuted in 130 countries on Wednesday in a surprise move that could potentially cost millions of new subscribers. 	 The expanded licensing agreement announced Tuesday will allow Netflix to showcase several new DreamWorks series, including "Trollhunters," a fantasy created by acclaimed movie director Guillermo del Toro.
After a Friday night shootout, the tiled foyer following the main glass door was stained with blood and forensic specialists in white suits were working inside. 	 Five people died in a gun battle as troops moved in.
Britain's Foreign Secretary Philip Hammond urges South Korea to refrain from resuming propaganda on the North Korean border. 	 South Korea retaliated for North Korea's nuclear test with broadcasts of anti-Pyongyang propaganda across the rival's tense border Friday, believed to be the birthday of North Korean leader Kim Jong Un.
In an interview for Rolling Stone with American actor Sean Penn, newly recaptured Mexican drug lord Joaquin "El Chapo" Guzman showed no remorse for leading one of the world's largest drug cartels. 	 enn's article on Guzman was published late Saturday by Rolling Stone magazine, a day after Mexican marines captured the world's most wanted kingpin in a raid on the city of Los Mochis near the Gulf of California.
In private, US officials expressed concern over Cuba's lack of interest in a policy change and criticized for example the island's government's decision to prevent thousands of medical specialists from leaving the country without special authorization. 	 Obama's actions on guns have drawn major attention in the presidential campaign, with the Democratic candidates backing Obama and the Republicans unanimously voicing opposition.
Penn reminded him of a shooting that killed another famous narco, Colombian Pablo Escobar, and asked how he thought it would be his last days in the drug trade. 	 Penn wrote that Guzman was interested in having a movie filmed on his life and wanted Mexican actress Kate del Castillo, who had portrayed a drug trafficker in a television series, involved in the project.
The influx was slower in December than in previous months, with 127,320 people arriving, compared with 206,101 in November. 	 The influx was slower in December than in previous months, with 127,320 people arriving - down from 206,101 in November.
Thelma Aldana, Attorney General and head of the Public Prosecutor's Office, told a press conference that "the cases we have documented against non-combatant civilians, including children," were one of the largest forced disappearances in Latin America. . 	 "The cases that we have documented were (attacks) against the non-combatant civilian population including children," Attorney General Thelma Aldana said.
The house where the Mexican capo Joaquin "El Chapo" Guzman tried to take refuge for the last time was not something out of the ordinary. 	 They raided Guzman's remote hideout a few days after the interview and narrowly missed capturing Guzman, whose July escape from Mexico's top security prison - though a mile-long (1.5-kilometer) tunnel - had embarrassed President Enrique Pena Nieto and made his capture a national priority.
Broadcasts include popular Korean pop songs, world news, weather forecasts, as well as criticism of North Korea's nuclear tests, its shaken economy and poor human rights conditions, according to the Seoul Ministry of Defense. 	 The broadcasts include popular Korean pop songs, world news and weather forecasts as well as criticism of the North's nuclear test, its troubled economy and dire human rights conditions, according to Seoul's Defense Ministry.
"We think that the level of refugees and asylum seekers who have arrived in Germany is too high and we are working to ensure that this does not happen on that scale in 2016," de Maiziere said. 	 "We think the level of refugees and asylum-seekers who have come to Germany is too high, and are working so that it isn't repeated on this scale in 2016," de Maiziere said.
The house where the Mexican capo Joaquin "El Chapo" Guzman tried to take refuge for the last time was not something out of the ordinary. 	 Two months after that close call, marines finally caught him in a residential neighborhood of Los Mochis, where they'd been monitoring a suspected safe house.
Kim aims to encourage pride and boost his domestic political agenda with an explosion that has aroused outrage in much of the world. 	 It also raised questions of ethics and judgment, namely whether Penn should have met secretly with one of the world's most-wanted fugitives, whether the actor crossed the line by giving Guzman approval over the article before it was published, and whether Penn trivialized El Chapo's murderous past by asking him such questions as "Do you have any dreams?" and "If you could change the world, would you?"
In 2002, when the United States threatened to invade Iraq under Saddam Hussein's regime, Penn visited that nation and met with senior officials. 	 According to a statement from the Mexican Attorney General's office, the U.S. filed extradition requests June 25, while Guzman was in custody, and another Sep. 3, after he escaped.
And it goes even further than Maduro in holding that many of the problems are due to the country being still too capitalistic. 	 He even goes further than Maduro in arguing that many of the country's problems are the result of being too capitalist.
It was a great example of exclusive information, but also something that Rolling Stone might regret. 	 It was a big scoop, and one Rolling Stone may well regret.
In private, US officials expressed concern over Cuba's lack of interest in a policy change and criticized for example the island's government's decision to prevent thousands of medical specialists from leaving the country without special authorization. 	 The government decided late last year to prevent thousands of medical specialists from leaving the country even for brief vacations without the Health Ministry's permission.
There were no immediate responses from either the Penn or Castillo to the Mexican official's comments. 	 Un vocero de la revista Rolling Stone no respondió de inmediato solicitudes de cometario de The Associated Press.
Penn, an Oscar-winning actor who played a drug dealer in the 1985 film "The Falcon and the Snowman," has had news encounters in other countries. 	 Penn wrote that Guzman was interested in having a movie filmed on his life and wanted Mexican actress Kate del Castillo, who had portrayed a drug trafficker in a television series, involved in the project.
August broadcasts, which began after Seoul blamed Pyongyang for a landmine that mutilated two South Korean soldiers, halted only after rival nations agreed on a series of measures to ease tensions. 	 When South Korea briefly resumed propaganda broadcasts in August after an 11-year break, Seoul says the two Koreas exchanged artillery fire, followed by threats of war.
Many Los Angeles residents have complained of headaches, nausea and dizziness. 	 During the course of the leaks, thousands of complaints of headaches, nausea and nosebleeds were made to the South Coast Air Quality Management District.
Guzmán was recaptured Friday in the town of Los Mochis, in his home state of Sinaloa, after a shootout in which five of his associates died and a Mexican Navy cash was wounded. 	 Mexican officials say Sean Penn's contacts with drug lord Joaquin "El Chapo" Guzman helped them track the fugitive down - even if he slipped away from an initial raid on the hideout where the Hollywood actor apparently met him.
The broadcasts will generate a furious response on the part of North Korea, which considers them an act of psychological warfare. 	 The broadcasts will draw a furious response from North Korea, which considers them an act of psychological warfare.
In total, 1,091,894 migrants were registered between January and December 2015, according to data released by the Ministry of the Interior. 	 Border crossings haven't returned to 2014 levels, but the numbers began to pick up again in June and have remained high even though migration usually slows down in the fall and winter.
"The Pope, as head of the Catholic Church, comes to meet the Mexican people, but it is a pastoral visit. He does not come, because I have read a lot of the press, which comes to solve problems of violence and disappearances," added Pierre . 	 Penn wrote that Guzman was interested in having a movie filmed on his life and wanted Mexican actress Kate del Castillo, who had portrayed a drug trafficker in a television series, involved in the project.
Since the electoral victory, the opposition coalition has been divided between those in favor of negotiating with the government and those who want to start the process of removing the president. 	 Hundreds of pro-government people rallied in downtown Thursday morning to protest the opposition leadership's removal of portraits of Chavez from the gold-domed capitol building.
Others say that in the end the approach will lead to substantial improvements for Cubans. 	 Others say easing tensions between the U.S. and Cuba will inevitably lead to better conditions on the island.
A family stopped as they passed through the area and posed for photos outside the Hotel Doux on the outskirts of Los Mochis, where seamen detained Guzman briefly after the raid. 	 Two months after that close call, marines finally caught him in a residential neighborhood of Los Mochis, where they'd been monitoring a suspected safe house.
Penn got the first interview with Guzman in early October, while the world's most wanted capo was at large after escaping in July from a maximum-security Mexican prison through a complex tunnel. 	 They raided Guzman's remote hideout a few days after the interview and narrowly missed capturing Guzman, whose July escape from Mexico's top security prison - though a mile-long (1.5-kilometer) tunnel - had embarrassed President Enrique Pena Nieto and made his capture a national priority.
Oscar Ray Bolin, a former carnival employee who was sentenced for killing three women in the Tampa Bay area and who after the trial married a member of his defense was executed in Florida on Thursday. 	 President Barack Obama tore into the National Rifle Association on Thursday as he sought support for his actions on gun control, accusing the powerful lobby group of peddling an "imaginary fiction" that he said has distorted the national debate about gun violence.
Some twenty-three of them preferred to stay on the island, either because they left political activism or remained as internal opponents. 	 Cuba's dissidents are viewed with skepticism by many ordinary Cubans who question their backing and motivation.
In private, US officials expressed concern over Cuba's lack of interest in a policy change and criticized for example the island's government's decision to prevent thousands of medical specialists from leaving the country without special authorization. 	 Meanwhile, U.S. officials privately express concerns about a reverse in Cuba's policy of granting greater freedoms for its people in recent years.
The United States Administration is convinced that North Korea has conducted a nuclear test, but the details of the test remain to be determined. 	 The UN Security Council has unanimously condemned North Korea’s most recent nuclear test, calling it a clear violation of UNSC resolutions.
Until then it was much like other houses in the neighborhood, with an open carport protected by a metal door. 	 Two months after that close call, marines finally caught him in a residential neighborhood of Los Mochis, where they'd been monitoring a suspected safe house.
"Dilma will have a month without major problems in Brasilia to present a plan to revive a shaky economy," said Claudio Couto of the Brazilian research institute Fundacao Getulio Vargas. 	 In the interview, Guzman defends his work at the head of the world's biggest drug trafficking organization, one blamed for thousands of killings.
The United States Administration is convinced that North Korea has conducted a nuclear test, but the details of the test remain to be determined. 	 The hydrogen bomb already is the global standard for the five nations with the greatest nuclear capabilities: the U.S., Russia, France, Britain and China.
North Korea said in a media statement that it carried out a successful test of a hydrogen bomb at a polygon in the north of the country. 	 Some believe North Korea might have detonated a boosted fission bomb, a weapon considered halfway between an atomic bomb and an H-bomb.
The Guatemalan prosecutor's office has requested that the immunity of President-elect Jimmy Morales' top adviser be removed for being related to human rights violations during the 1960-96 war. 	 Prosecutors on Wednesday announced the arrest of more than a dozen former military and government officials for alleged crimes against humanity committed during Guatemala's civil war, and initiated human rights proceedings against an ally of President-elect Jimmy Morales.
According to the prosecution, Ovalle would be linked to forced disappearances, human rights violations, during the war, especially in the military detachment located in Cobán Alta Verapaz, in the north of the country, where he was outstanding. 	 The suspects face charges of crimes against humanity involving massacres and disappearances of people by security forces under their command.
"We think that the level of refugees and asylum seekers who have arrived in Germany is too high and we are working to ensure that this does not happen on that scale in 2016," de Maiziere said. 	 She said it was very important both to "achieve an appreciable reduction of the refugees" - by tackling the reasons people are fleeing and sending home rejected asylum-seekers - and preserve freedom of movement within the European Union.
Penn's article on Guzman was published Saturday by Rolling Stone magazine, a day after Mexican Navy officials captured the world's most wanted drug-dealing chief during an operation in the Los Mochis town near the Gulf of California . 	 Penn's article on Guzman was published late Saturday by Rolling Stone magazine, a day after Mexican marines captured the world's most wanted kingpin in a raid on the city of Los Mochis near the Gulf of California.
In private, US officials expressed concern over Cuba's lack of interest in a policy change and criticized for example the island's government's decision to prevent thousands of medical specialists from leaving the country without special authorization. 	 A number of Cuban activists say the new U.S. policy of engagement focuses on diplomatic and economic ties instead of improving human rights.
"If I killed, I killed in combat, facing my troops and not as a coward or anything like that," he told reporters. 	 "If I killed, I killed in combat, leading my troops and not as a coward or anything like that," Lucas told reporters at the courthouse.
Writing for Rolling Stone, Penn admitted that Guzman was granted the benefit of approving the article before it was published (Guzman did not request changes, according to the actor), which represents a violation of the general rules of journalistic integrity. 	 "He was interested in seeing the story of his life told on film, but would entrust its telling only to Kate," wrote Penn, who appears in a photo posted with the interview shaking hands with Guzman.
In the interview published on Saturday night, Guzman said he entered the drug business at age 15 because there was no other way to survive. 	 When asked if he is to blame for high addiction rates, he responds: "No, that is false, because the day I don't exist, it's not going to decrease in any way at all. Drug trafficking? That's false."
Germany received more refugees and migrants from other causes than any other European country. 	 Many Germans cheered as weary Syrians, Afghans and Iraqis stepped off trains in Munich, Frankfurt and Hamburg last summer and tens of thousands have volunteered to help the new arrivals.
Penn got the first interview with Guzman in early October, while the world's most wanted capo was at large after escaping in July from a maximum-security Mexican prison through a complex tunnel. 	 Penn's article on Guzman was published late Saturday by Rolling Stone magazine, a day after Mexican marines captured the world's most wanted kingpin in a raid on the city of Los Mochis near the Gulf of California.
FIFA's ethics committee has sanctioned Platini and Blatter for eight years last month in determining that they committed unethical conduct in connection with a payment of two million Swiss francs (two million dollars) that Blatter secretly made to Platini in 2011. 	 Paraguayan authorities raided the headquarters of the South American soccer confederation Thursday in connection to the sprawling FIFA probe being led by U.S. and Swiss prosecutors.
Chancellor Angela Merkel has emphasized the importance of diplomacy and getting other European countries to share the burden, but her conservative allies in Bavaria propose to set a limit on the number of refugees the country can accept. 	 Chancellor Angela Merkel has emphasized the importance of diplomacy and getting other European countries to share the burden, but her conservative allies in Bavaria advocate setting a cap on the number of refugees Germany can take.
Chiapas, in the southeast, is one of the poorest states with the largest indigenous presence in the country, and where in recent years the presence of evangelical churches has grown. 	 In the interview, Guzman defends his work at the head of the world's biggest drug trafficking organization, one blamed for thousands of killings.
The wars between the Sinaloa Cartel of Guzman and the local cartel of Ciudad Juárez made the city one of the most dangerous in the world around 2010. 	 In the interview, Guzman defends his work at the head of the world's biggest drug trafficking organization, one blamed for thousands of killings.
However, a month or two of intensive renovations transformed the house into a structure that was architecturally nothing special, but was completely closed. 	 Two months after that close call, marines finally caught him in a residential neighborhood of Los Mochis, where they'd been monitoring a suspected safe house.
Penn asked to take a picture of him being seen shaking hands with Guzman to prove to his editors that he had really seen him. 	 "He was interested in seeing the story of his life told on film, but would entrust its telling only to Kate," wrote Penn, who appears in a photo posted with the interview shaking hands with Guzman.
"China now had a particular focus that I wanted to do, and we agreed and gave them space to put it into practice, but today, in my conversation with China, I made it very clear that it has not worked and that we can not continue as we have done" "Kerry said. 	 To build its nuclear program, the North must explode new and more advanced devices so scientists can improve their designs and technology.
Four families who were due to be deported Wednesday received an amparo from the Immigration Appeals Board, after the coalition of legal and pro-immigrant organizations CARA Project appealed their asylum cases. 	 Amid widespread shock over a string of sexual assaults in this cosmopolitan German city on New Year's Eve, the response was divided Wednesday: blame the police or chide the victims, deport criminal foreigners or prevent migrants from entering the country in the first place.
Most of the detainees are over 65 years old, including retired general Francisco Luis Gordillo and Major General Manuel Antonio Callejas Callejas, who were members of the military leadership in the 1980s. 	 Children in the shelters, most of them between ages 14 and 17, stay an average of 32 days.
Exactly one year ago the Cuban government began to release 53 prisoners from a list for which President Barack Obama had interceded in the framework of the reestablishment of relations between Cuba and the United States. 	 One year ago, the Cuban government began releasing 53 political prisoners that President Barack Obama wanted freed as part of a historic deal to re-establish diplomatic relations between the former Cold War foes.
"I was interested in seeing the story of his life told in the movies, but I would only trust Kate to tell it," he added. 	 "He was interested in seeing the story of his life told on film, but would entrust its telling only to Kate," wrote Penn, who appears in a photo posted with the interview shaking hands with Guzman.
The prosecution confirmed that at least 13 other soldiers were detained for the same case, including Gen. Benedicto Lucas Garcia, brother and former chief of the staff of the late ex-president Romeo Lucas Garcia (1978-1982). 	 Guatemalan officials say a prison riot in the eastern state of Izabal has left eight inmates dead.
Regardless of what Rousseff proposes, Congress may simply not approve. 	 Penn's long and often rambling essay, widely mocked on social media, included comments from Guzman on everything from his childhood to his thoughts on the drug trade.
Now Netflix is ​​available in 21 languages ​​and is transmitted virtually in every market in which it has targeted, with the notable exception of China, the most populous country in the world. 	 Now, Netflix is available in 21 different languages and streaming in just about every market that it had in its sights, with the notable exception of China, the world's most populous country.
"I have 50 years here and in those 50 years I have never heard a rumor, a sign, I never saw a note that this person could be in Mochis or that could be living in Mochis," said Lopez Valdez. 	 Two months after that close call, marines finally caught him in a residential neighborhood of Los Mochis, where they'd been monitoring a suspected safe house.
Netflix has already fulfilled its major purpose of New Year. 	 Netflix has already crossed off the biggest item on its New Year's list of resolutions.
Penn's lengthy and occasionally bewildering essay, which received widespread scorn in social media media, included comments from Guzman of all kinds, from his childhood to his reflections on the drug trade. 	 Penn's long and often rambling essay, widely mocked on social media, included comments from Guzman on everything from his childhood to his thoughts on the drug trade.
Cunha has said that no new legislation will be voted on until lawmakers decide on the structure of the commission that will consider the impeachment. 	 Rolling Stone has long mixed aggressive investigative and political reporting with coverage of rock stars and other celebrities.
Global groups like Amnesty International indicated that it is the Cuban government and not the United States that has to act in its territory. 	 International advocacy groups such as Amnesty International say that no matter what the United States does, it's up to Cuba to improve the island's human rights situation.
The capo added that he is not responsible for the epidemic of illegal drug use in the United States and the rest of the world. 	 When asked if he is to blame for high addiction rates, he responds: "No, that is false, because the day I don't exist, it's not going to decrease in any way at all. Drug trafficking? That's false."
Chancellor Angela Merkel has emphasized the importance of diplomacy and getting other European countries to share the burden, but her conservative allies in Bavaria propose to set a limit on the number of refugees the country can accept. 	 The U.S. government plans to open three new shelters in three states to house unaccompanied migrant children as officials brace for another influx of young Central American immigrants crossing the border.
Bolin was also sentenced for the death of 17-year-old Stephanie Collins. 	 All the candidates running for the Democratic presidential nomination support stricter gun laws, so Obama's declaration in a New York Times op-ed isn't likely to have an impact on the race to replace him.
Some observers believed that Maduro would initiate some economic reforms after the opposition won a national election for the first time in more than a decade, setting the stage for an unprecedented political confrontation. 	 Maduro named other hardliners to top spots Wednesday as part of a larger cabinet reshuffle he says is intended to protect the revolution during a new political era. And he created a new urban agriculture ministry and announced that he and first lady Cilia Flores had taken up urban farming themselves.
